
      
                                            SO ./images/cube.png
WE ./images/cube.png
EA ./images/cube.png
NO ./images/cube.png

C                         0,0,1
F                          255,123,145

1111111111
10W0000001
1000100001
1000000001
1111111111