        SO ./mandatory/images/walls/s.png
WE     ./mandatory/images/walls/w.png
EA ./mandatory/images/walls/e.png
C 80,20,0
F                          10,20,40          
NO ./mandatory/images/walls/n.png


11111111111111111111111111111111111
10000100000001010111111111111100001
101010100000010011           1000011
1000110000010000011         100001
10001100000000011111         1000011
10001100000000000001         1000001
10001100010000000001        1111100011
100011111 11111111101    111000011111
10001            101111 100001111
1001          111000000100011
101         1100000000000001
101        100000000W0000001
101       1000000000000000001
101111111100000000001000000001
10000000000000000000000000001
111111111100000000001000000001
          1000000000000000001
           10000000000000001
            110000000000011
              111000001111
               1111111