        SO  ./images/cube.png      
WE     ./images/cube.png
EA ./images/cube.png
C 0,0,10
F                          0,25,255          
NO ./images/cube.png


11111111111111111111111111111111111
10000100000001010111111111111100001
101010100000010011          1000011
1000110000010000011         100001
10001100000000011111         1000011
10001100000000000001         1000001
10001100000000000001	       11000011
100011111111111111101    111000011
10001            101111 100001111
1001          111000000100011
101         110000000000001
101        10000000000000001
101       1000000000000000001
101111111100000000001000000001
100000000000000000W10000000001
111111111100000000000000000001
          1000000000000000001
           10000000000000001
            110000000000011
              111000001111
               1111111