SO ./mandatory/images/walls/s.png

WE     ./mandatory/images/walls/w.png

EA ./mandatory/images/walls/e.png

C 140,100,0
F                          40,70,70


           NO ./mandatory/images/walls/n.png

         



11111111111111111111111111111111111
10000000000100000000000000000000111
10000000000100000000000111000000111
10001000000000000000001111100000111
10000000000100000000001111100000111
10000000000100000000001111100000111
100000W0000100000000011111000001111
11111111111111111111111111111111111