SO ./images/cube.png
WE     ./images/cube.png
EA ./images/cube.png
C 0,0,10
F                          a,25,123
NO ./images/cube.png

11111111111111111111111111111111111
10000000000100000000000000000W00111
10000000000100000000000111000000111
10000000000100000000001   100000111
10000000000100000000001    100000111
10000000000100000000001     100000111
1000000000010000000001       1000001111
11111111111111111111111111111111111