SO ./images/cube.png

WE     ./images/cube.png

EA ./images/cube.png

C 10,10,10
F                          10,10,123


           NO ./images/cube.png

         



11111111111111111111111111111111111
10000000000100000000000000000000111
10000000000100000000000111000000111
10000000000100W00000001   100000111
10000000000100000000001    100000111
10000000000100000000001     100000111
1000000000010000000001       1000001111
11111111111111111111111111111111111