SO ./bonus/images/walls/s.png

WE     ./bonus/images/walls/w.png

EA ./bonus/images/walls/e.png

C 140,100,0
F                          40,70,70


           NO ./bonus/images/walls/n.png

         



1111111111111111111111
1000000000010000000111
1000000000010000000111
10001E00000C0000000111
1000000000010000000111
1000000001110000000111
1000000000010000001111
1111111111111111111111