        SO ./bonus/images/walls/s.png
WE     ./bonus/images/walls/w.png
EA ./bonus/images/walls/e.png
C 0,0,10
F                          0,25,255          
NO ./bonus/images/walls/n.png


11111111111111111111111111111111111
10000100000001010111111111111100001
101C10100000010011           1000011
1C10110000010000011         100001
10101100000000011111         1000011
10101100000000000001         1000001
10101100010000000001	    111C100011
101C11111 11111111101    111000011111
10001            101111 100C01111
1001          111000000101C11
1C1         1100000000000001
101        100000000W0000001
1C1       1000000000000000001
101111111100000000001000000001
10000000C00000000000000000001
111111111100000000001000000001
          1000000000000000001
           10000000000000001
            110000000000011
              111000001111
               1111111